g1g1g1g1g1g1g1g1g1g1g1g1g1

w0w0w0g0g0g0g0g0g0g0g0g0g0

r0r0r0r0r0r0r0r0r0r0r0r0r0

g0g0g0g0g0g0g0g0g0g0w0w0w0

p0p0p0p0p0p0p0p0p0p0p0p0p0

b0b0b0g0g0g0g0g0g0g0g0g0g0